10 10
###########
  #      ##
# # #### ##
# # #  # ##
# # ## # ##
# #    # ##
# # ## # ##
# #### # ##
#      #  
###########
