sz 10
##########
  #      #
# # #### #
# # #  # #
# # ## # #
# #    # #
# # ## # #
# #### # #
#      #  
##########
